NO textures/grey_stone.xpm
SO textures/purple_stone.xpm
WE textures/wall_brick.xpm
EA textures/wood.xpm

F 18,53,25
C 153,204,255

111111111111
110000000S11
110000000011
110000000011
110000000011
110000000011
110000000011
110000000011
110000000011
111111111111

