NO textures/bluestone.png
SO textures/mossy.png
WE textures/redbrick.png
EA textures/eagle.png

F 18,53,25
C 153,204,255

111111111111
111111111111
11S111111111
111111111111
111111111111
111111111111
111111111111
111111111111
111111111111
111111111111
111111111111
111111111111
111111111111
