   WE                            textures/grey_stone.xpm
NO      textures/purple_stone.xpm



SO textures/wall_brick.xpm

F      0017,    238,     64

EA textures/wood.xpm



C -184, 234, 235


1111111
1000001
110N011
1000001
1111111
